WSWWWWWWWW
__W______W
_WWW_W_W_W
_____W_WWW
WWWWWW_WEW
WW_____W_W
WW_WWWWW_W
WW_____W_W
WWWWWW_W__
WWWWWW____
